La migliore canzone italiana di sempre | Una canzone italiana degli ultimi anni
Il piatto che rappresenta meglio l’Italia | Il piatto italiano più buono
La città più bella d’Italia | La città italiana piu bella che hai visitato
Il regalo perfetto | Il regalo che faresti a tua madre
Il miglior modo di passare un sabato sera | Il modo in cui passi solitamente il sabato sera
La miglior pizza | La pizza più strana ma buona
La vacanza ideale | L'ultima vacanza che hai fatto
Il personaggio dei cartoni animati migliore | Il personaggio dei cartoni animati più irritante
Il miglior hobby | Il passatempo più inutile
Il miglior frutto | Il frutto che mangi piu spesso
La canzone più romantica | La canzone d’amore più sopravvalutata
Il miglior superpotere | Il superpotere più utile per rapinare una banca
Il modo migliore per rilassarsi | Il modo che usi per rilassarti solitamente
Il miglior tipo di vacanza | Scrivi mare o montagna
Il lavoro dei sogni | Il lavoro più stressante
Il miglior libro che hai letto | Il miglior libro di sempre
La foto perfetta da mettere sui social | La foto meno adatta da mettere sui social
Il miglior modo per passare una domenica | Il modo in cui passi il sabato
Il programma TV migliore | Il programma TV più trash che però ti piace
La bevanda estiva perfetta | La bevanda estiva piu sopravvalutata
Il miglior tipo di gelato | Il gusto di gelato alla frutta che prendi piu spesso
Il miglior cibo da mangiare durante una serata a casa con amici | Il miglior cibo da mangiare durante un aperitivo
La lingua più affascinante | La lingua più difficile da imparare
Il miglior animale | L'animale più incredibile che hai visto allo zoo
Il posto perfetto per vivere | Il posto dove vivi
Il regalo di compleanno perfetto | Il regalo di compleanno che ti hanno fatto
La colazione perfetta | Lo spuntino di mezzanotte perfetto
Il mezzo di trasporto più utile | Il mezzo di trasporto più scomodo
Il miglior sport da praticare | Lo sport che pratichi
Il miglior film d’animazione | Il primo film d'animazione che hai visto
Il luogo ideale per una vacanza invernale | Un luogo in cui si va a sciare
La canzone più triste | La canzone triste più sopravvalutata
Il miglior profumo naturale | Un buon cibo
La bevanda perfetta | La bevanda che bevi al mattino
Il miglior cartone animato della tua infanzia | Il cartone più dimenticabile della tua infanzia
Il miglior modo per passare il tempo in treno | Il miglior modo per passare il tempo in autobus
Il dessert perfetto | Il dessert che piace a tutti ma a te no
Il miglior strumento musicale | Lo strumento musicale più difficile
Il miglior artista musicale italiano | L’artista musicale italiano più sopravvalutato
Il piatto tipico più buono | scrivi un piatto tipico della tua città/regione
La miglior invenzione della storia | L’invenzione che utilizzi piu spesso
Il miglior supereroe | Il supereroe più debole
La vacanza da sogno | La prossima vacanza che vorresti fare
Il miglior attore internazionale | L’attore internazionale più sopravvalutato
Il miglior snack salato | Il miglior snack da mangiare davanti la tv
La miglior app per smartphone | Il gioco da telefono a cui giochi piu spesso
La canzone che mette più allegria | La canzone ascolti piu spesso
Il modo migliore per affrontare un lunedì | La prima cosa che fai appena sveglio
Il modo perfetto per passare il Capodanno | Il modo perfetto per passare un sabato sera
Il film più spaventoso | Il film horror meno spaventoso
Il miglior mezzo per viaggiare | Il mezzo con cui vorresti metterti alla guida adesso
Il lavoro ideale | Il lavoro che volevi fare da bambino
Il miglior tipo di pane per un panino | Il miglior tipo di pane per fare la scarpetta
Il miglior regalo ricevuto | Il regalo che vorresti per Natale
La cosa più utile da avere sempre con sé | Un oggetto che hai in tasca
La cosa più interessante da collezionare | La collezione più inutile
Un cibo sano | Un cibo con cui hai cenato
Il miglior passatempo durante la pioggia | Un passatempo da fare in casa
Il miglior attore comico | L’attore comico meno divertente
Il miglior tipo di vacanza con amici | Il miglior tipo di vacanza in famiglia
Il miglior giorno della settimana | Un giorno della settimana
Il miglior sport di squadra | Lo sport di squadra più difficile
Il miglior strumento da cucina | Un utensile da cucina
Il miglior modo per rilassarsi dopo il lavoro | Il miglior modo per rilassarsi la sera
Il miglior cibo per un picnic | Il cibo da portare per una gita con la scuola
Il miglior luogo per un primo appuntamento | Il luogo in cui usciresti con tua madre
Il miglior mezzo per esplorare una città | Il mezzo che useresti per
Il dessert più bello da vedere | Il dessert più buono
Il miglior film comico | Il film comico meno divertente
Il miglior tipo di colazione | Il tipo di colazione meno saziante
La cosa più importante da portare in montagna | La cosa più importante in campeggio
Il miglior animale fantastico | Scrivi una creatura mitologica
Il miglior tipo di film | Il genere dell'ultimo film che hai visto
età media in cui si va a vivere da soli | età in cui una persona inizia a lavorare
numero di viaggi all'anno che una persona vorrebbe fare | numero di viaggi all'anno che una persona riesce davvero a fare
numero di scarpe che una persona media possiede | numero di scarpe che usi veramente
numero ideale di ore di sonno a notte | numero reale di ore che dormi ogni notte
quante tazze di caffè si bevono in media al giorno | quante tazze di caffè si bevono nei periodi stressanti
numero di serie TV iniziate e mai finite | numero di serie TV viste più di una volta
età in cui si prende la patente | Scrivi un numero da 10 a 30
numero medio di amici stretti | numero di amici con cui ti senti ogni settimana
quante volte si controlla il telefono al giorno | quante volte si dovrebbe controllare il telefono al giorno
numero di ore passate sui social ogni settimana | numero di ore passate su DrewGames ogni settimana
quanti esami hai passato al primo colpo | quanti esami in cui sei stato bocciato
quanti film si guardano in un mese | quante volte al mese vai in palestra
quanti messaggi si mandano al giorno | quanti messaggi ricevi in un giorno
età in cui si ha il primo lavoro retribuito | età in cui si capisce quanto vale il proprio tempo
numero medio di password usate | numero di password ricordate a memoria
numero di paesi che si vorrebbe visitare | numero di paesi visitati finora
quanti libri si leggono in un anno | quanti libri si iniziano e non si finiscono
quanti regali si fanno a Natale | quanti regali si ricevono a Natale
numero di sport provati nella vita | numero di sport praticati per 3+ anni
quante app si hanno installate | quante app si usano davvero ogni giorno
quanti account social si posseggono | quanti account social si usano regolarmente
Un cibo che odiavi da piccolo | Un cibo che hai sempre amato da bambino
Una serie TV da binge-watchare | Una serie TV che richiede riflessione
Un personaggio famoso che stimi | Un personaggio famoso che non ti convince
Una lingua che vorresti imparare | Una lingua che ti incuriosisce ma non studieresti mai
Una cosa che porteresti su un'isola deserta | La prima cosa che desidereresti su un isola deserta
Una canzone da karaoke | Una canzone impossibile da cantare ma che ami
Un’attività sportiva divertente | Un’attività sportiva faticosa ma soddisfacente
Un piatto tipico italiano | Un piatto tipico della tua regione
Un momento imbarazzante in pubblico | Un momento in cui eri ubriaco
Un oggetto da tenere sulla scrivania | Un oggetto che sparisce sempre quando serve
Un animale marino affascinante | Un animale marino di cui avresti paura
Una festività che ami | Una festività che ti mette nostalgia
Un cibo da strada delizioso | un cibo da strada sopravvalutato
Una cosa che odi dimenticare a casa | Una cosa che dimentichi sempre a casa
Un animale che trovi elegante | Un animale che trovi simpatico
Un simbolo di libertà | Un simbolo di responsabilità
Un locale perfetto per una serata tranquilla | Un locale in cui ti piace andare la sera
Un errore che ti ha insegnato qualcosa | Un successo che ti ha sorpreso
Un animale che vorresti come compagno d’avventura | Un animale che sarebbe difficile da gestire come compagno
Un'app indispensabile | Un'app che usi troppo spesso
Un gioco da fare in compagnia | Un gioco che ti prende anche da solo
Un'app che tutti usano | Un'app che usi tutto il giorno
Un oggetto che conservi da anni | Un oggetto che cambi spesso
Un'attività da fare al mattino | Un'attività che dovresti fare al mattino ma non fai
Un'abitudine quotidiana | Un'abitudine che vuoi perdere
Una frase che ti ripeti spesso | Una frase che odi sentirti dire
Un colore che mette allegria | Un colore che trasmette calma
Un segreto buffo che puoi dire | Un dettaglio di te che nessuno sa
Una tua stranezza | Una tua abitudine comune
Un film che tutti dovrebbero vedere almeno una volta | L'ultimo film che hai visto
Un capo d’abbigliamento che non metti mai | Un capo d'abbigliamento che proprio non ti piace
Un luogo dove hai riso tanto | Un luogo dove ti diverti
Un’attività creativa | Un tipo di arte
Un hobby rilassante | Un hobby che proprio non ti piace
Una cosa che ti rilassa a fine giornata | Una cosa che fai tornato a casa dopo scuola
Un evento che aspetti ogni anno | Il giorno che salva l’anno
Un gusto di gelato preferito | Un gusto di gelato che piace a tutti ma a te no
Un oggetto vintage che vorresti avere | Un oggetto vintage che ancora utilizzi
Il tuo animale preferito | Un animale che ti rappresenta personalmente
Il Bolt del regno animale | Un animale veloce
Una vacanza che sogni da tempo | La città più bella del mondo
Una parola poco utilizzata | Una parola difficile da pronunciare
Una città da visitare in autunno | Una città dove vorresti passare una giornata
Un gesto romantico | Un regalo da fare a san Valentino
Un regalo perfetto per un amico | Un regalo speciale per la tua dolce metà
Un’attività da fare con amici | Un’attività da fare da soli
Un gadget tecnologico che usi spesso | Un gadget tecnologico che vorresti comprare
Un’attività tipica del weekend | Un’attività che fai nei momenti liberi in settimana
Un capo d’abbigliamento comodo | Un capo d’abbigliamento che indossi spesso
Un lavoro che faresti per passione | Un lavoro che faresti per i soldi
Una cosa da portare in campeggio | Una cosa da portare in montagna
Un piatto perfetto per un primo appuntamento | Un primo piatto
Una competenza che vuoi imparare | Una competenza che stai imparando
Un luogo ideale per leggere un libro | Il luogo dove leggi solitamente
Un artista che ti piace | Un artista che secondo te è sopravvalutato
Un’attività che ti faceva paura | Un'attività che non faresti mai
Un film da vedere con la famiglia | Un film da vedere da soli
Una persona che ammiri | Una persona in cui non vorresti mai ritrovarti
Un colore per una stanza | Un colore per un accessorio
Una serie animata indimenticabile | Una serie animata che non tutti conoscono
Un oggetto che porti sempre con te | Un oggetto che non usi mai ma non riesci a buttare
Un ricordo lontano che sembra recente | Un ricordo che sembra lontanissimo
Un personaggio storico affascinante | Un personaggio storico controverso
Un dolce per una festa | Un dolce che mangeresti senza mai stancarti
Il miglior cibo per un brunch | Il miglior piatto per una colazione
Una canzone che mette subito di buon umore | Una canzone di cui conosci tutto il testo
Una pubblicità che ti ha sempre fatto ridere | Una pubblicità molto strana
Un film che tutti amano | Un film che pochi conoscono ma che ti ha colpito
Un colore che indossi spesso | Il tuo colore preferito
Una citazione che ti ispira | Inventa una citazione
Un’esperienza che consiglieresti | Un'esperienza che faresti con un amico
Una meta per un viaggio on the road | Una meta per un viaggio di relax totale
Un cibo da mangiare d’estate | Un cibo che ami anche fuori stagione
Una bevanda da spiaggia | Una bevanda da serata estiva
Un animale domestico che vorresti | Un animale domestico particolare
Un oggetto tecnologico utile | Un oggetto tecnologico superfluo ma divertente
Una cosa che odi fare | Una cosa che ami anche se è faticosa
Un film d’azione memorabile | Un film thriller che ti è piaciuto
Un film comico che non ti fa ridere | Un film che ti ha fatto ridere a crepapelle
Il miglior condimento per la pizza | La miglior farcitura per un panino
Il numero perfetto di persone per una vacanza | Il numero ideale per una cena a casa
Un ingrediente particolare che si mangia a colazione | Un ingrediente che trovi sempre a pranzo
Un colore che indossi spesso | Un colore che vorresti indossare di più
Un piatto che ti cucini da solo | Un piatto che ordini spesso ma che ti piacerebbe saper fare
Il miglior momento per allenarsi | Il momento della giornata in cui ti senti più attivo
Un film da vedere in compagnia | Un film che ami riguardare
Il numero di ore ideali per dormire | Il numero di ore che dormi
Un’app che usi ogni giorno | Un sito che visiti ogni giorno (+100 punti se è partygamesdrew.com!)
Una cosa che fai appena sveglio | Una cosa che fai prima di dormire
Un’attività rilassante | Un’attività che ti fa staccare dal telefono
Un posto dove ti concentri bene | La stanza che ami di più della tua casa
Una vacanza che sogni da tempo | Una vacanza che ti ha cambiato
Una serie TV che hai amato | Una serie TV che consigli spesso
Un cartone che guardavi da piccolo | Un cartone che guardi/guarderesti anche da adulto
Una bevanda da spiaggia | Una bevanda da festa
Una cosa che porti al mare | Una cosa che porti in vacanza
Un piatto che ti cucini da solo | Un piatto che ordini spesso
Un ingrediente che non deve mancare a colazione | Un ingrediente che trovi sempre a pranzo
Un film da vedere in compagnia | Un film che ami riguardare
Il miglior personaggio di un videogioco | Un personaggio di un videogioco
Quante password usi | Quante password ricordi a memoria
Quanti sport hai provato nella vita | Quanti sport hai praticato per almeno 3 anni
Quante ore passi al computer ogni giorno | Quante ore passi davanti al telefono ogni giorno
Quanti paesi vuoi visitare nella vita | Quanti paesi hai già visitato
Quante volte al mese vai in palestra | Quante volte al mese salti la palestra
Quante foto hai nella galleria del telefono | Quante ne cancelleresti subito
Quante lingue ti piacerebbe parlare | Quante lingue parli effettivamente
Quante volte mangi fuori a settimana | Quante volte mangi a asporto
Quanti televisori hai a casa | quanti telefoni hai avuto e cambiato
L'età più giovane per fidanzarsi | Un numero compreso tra 18 e 35
A che età i tuoi genitori ti hanno dato la prima paghetta | A che età i tuoi genitori ti hanno comprato per la prima volta un videogioco
A che età dovresti smettere di andare a bere con gli amici | Un numero compreso tra 21 e 90
Quale videogioco richiede maggiori skill | Quale videogioco vorresti fare con i tuoi figli?
Con quale attore/attrice andresti a cena | Quale attore/attrice è sottovalutato?
Se un personaggio di un cartone/film fosse tuo padre, chi sceglieresti? | Il miglior villain di un film/cartone
Quanto pagheresti per comprare una casa | Scegli un valore nel range tra 300k e 2 mln
Quale è la peggior emoticon da inviare all' FBI | Quale è la peggior emoticon da inviare al proprio partner
Età media per iniziare a lavorare | Un numero tra 10 e 30
Cosa diresti a un animale se potessi parlare con lui | Peggior cosa da dire al primo appuntamento
Se dovessi scambiare la tua vita con quella di un altro qui presente, chi sceglieresti? | Chi è il più divertente tra quelli qui presenti?
Quale personaggio di film/ cartone sarebbe il tuo miglior amico? | Quale personaggio di film/cartone animato elimineresti?
Quale personaggio di film/cartone vorresti essere | Quale è il miglior villain di un film/cartone animato?
La prima cosa che compreresti dopo aver vinto alla lotteria | Quale oggetto di lusso è il più sopravvalutato
La miglior città dove andare in viaggio di nozze | La miglior città dove andare con i tuoi amici
Miglior attività da fare con gli amici | Miglior attività da fare con la tua ragazza/ il tuo ragazzo
Quale paese ha la miglior popolazione | Quale paese ha il miglior cibo?
Quale evento sportivo ti piace vedere in TV | Qual è lo sport più sopravvalutato?
L'altezza ideale per te | Quale altezza dovrebbe avere il tuo ragazzo/la tua ragazza?
Da 1 a 10 quanto ti ritieni bello | Da 1 a 10 quanto è bella la serie tv peaky blinders? Se non l'hai vista, rispondi con un numero da 1 a 10
L' età che vorresti avere per il resto della tua vita | Un numero tra 5 e 40
Quale animale vorresti a fianco a te durante un apocalisse zombie | quale animale ti fa più paura
Quanto tempo rimani a letto prima di alzarti la mattina | quanto tempo ci metti ad addormentarti la sera
Quale celebrità porteresti con te in un isola deserta | La celebrità che ti sta più antipatica
Miglior orario per andare ad allenarsi | Il miglior orario per uscire con gli amici
Canzone che canteresti al karaoke | Una canzone triste
In quale film vorresti vivere | Un film da vedere col proprio partner
Quale parte del corpo ti piace di più | quale parte del tuo corpo cambieresti
Cantante preferito | Cantante sopravvalutato
Quale paese ha le donne più attraenti | In quale paese si scopa di più
Il maggior numero di volte che ti sei masturbato in un giorno | Quante volte vai al bagno in un giorno
Una celebrità con la quale scambieresti la tua vita | Quale celebrità non vorresti mai essere?
Quale alcolico bevi più spesso | L'alcolico con cui ti sei ubriacato l'ultima volta
Quanti km riusciresti a correre di fila? | Un numero tra 2 e 20 
A che ora ti svegli di solito? | A che ora ti svegliavi per andare a scuola/università?
La materia scolastica più difficile | La materia scolastica in cui eri più bravo
Il cartona animato che hai guardato per più tempo | Il cartone animato più sopravvalutato
L’animale peggiore da trovarti in camera | un animale selvatico qualunque 
Il luogo perfetto per il primo appuntamento | Un luogo sopravvalutato per un primo appuntamento
Un amico che non presenteresti/avresti voluto presentare mai ai tuoi genitori | Un amico perfetto da portare a una festa folle
Uno sport che ti sarebbe piaciuto fare da piccolo | Uno sport che non hai mai guardato in tv
La velocità perfetta da mantenere in autostrada | Un numero tra 50 e 200
L’età in cui vorresti rimanere per sempre | A che età vorresti sposarti?
Il popolo antico di cui ti sarebbe piaciuto far parte | Un popolo antico su cui ti hanno interrogato a scuola
Se avessi una macchina del tempo, in quale periodo storico andresti? | Nomina un periodo storico
La prima cosa che guardi in una donna | Tette o culo?
L’anno di scuola migliore | L’anno di scuola in cui ti hanno riempito di compiti
Un cantante che ha fatto una sola bella canzone | Un cantante che non tolleri
Faresti cannibalismo per 1.000.000 €? | Rispondi Si o No
Il tuo parente preferito | Il parente più stupido che hai
Quale cosa faresti una sola volta nella vita? | Nomina una droga pesante qualsiasi
Un animale che cancelleresti dalla faccia della terra | l’animale non domestico che vedi più spesso
Quanti pasti fai al giorno? | Un numero da 1 a 10
Il miglior libro che hai letto | Il primo libro che hai letto
Un paese che visiteresti di inverno | Il paese più freddo del mondo
Se potessi visitare un altro pianeta, quale sceglieresti? | Nomina un pianeta
Una cosa che non può mancare al primo appuntamento | Una cosa che non può mancare in discoteca
Qual è stata la tua prima crush da bambino? | Nomina un personaggio femminile dei cartoni animati/ serie tv 
Un amico che non potrebbe mai fare il tuo lavoro | Nomina un tuo amico qualunque
Uccideresti un tuo parente per 1.000.000.000€ | Rispondi Si o no 
Hai mai baciato una persona del tuo stesso sesso? | Rispondi Si o no
Qual è il dialetto più incomprensibile? | Qual è il dialetto che non sopporti proprio?
Un videogame che è migliore se giocato in gruppo | Un videogame che hai giocato veramente tanto 
L’applicazione del telefono che usi di più | il tuo social network preferito
Un’attività in cui le donne sono superiori agli uomini | nomina una faccenda di casa
Il software/applicazione che usi di più nel tuo computer | Rispondi con uno dei seguenti: Microsoft Word, Excel, Visual Studio, Discord, Powerpoint
Qual è un luogo in cui sei stato che non è molto comunemente visitato | Il luogo peggiore in cui sei andato in vacanza
In quante regioni d’Italia sei stato? | Un numero tra 10 e 20
Qual è la regione d’Italia con la migliore cucina? | Qual è la regione d’Italia più bella dal punto di vista naturale?
La città più sopravvalutata | Qual è una città in cui torneresti solo per bisogno?
A quale percentuale di batteria del telefono inizi ad essere in ansia? | Un numero tra 1 e 70
Un politico che tutti insultano ma per te non è così male | Un politico che ritieni pessimo
Il luogo peggiore in cui sei andato in vacanza | La località di provenienza della tua famiglia materna
La persona peggiore a cui bestemmiare davanti | La persona peggiore da portare in vacanza con gli amici
Il voto più basso che hai preso a scuola | Quante volte ti masturbi al giorno?
Quanto sei attraente da 0 a 10? | Dai un voto al film “Jurassic Park”
Una materia bella ma in cui avevi un professore pessimo | Una materia di scuola brutta in cui avevi un professore bravissimo
L’esame universitario a cui avresti voluto un voto più alto | L’esame universitario che ti è piaciuto di più 
L’orario in cui solitamente fai colazione | Il migliore orario per svegliarsi in un weekend tranquillo 
Il migliore orario per andare a dormire quando non hai piani per la sera | L’orario in cui esci normalmente la sera per incontrare i tuoi amici